20 20
650 150
4 4 4 4 4 4 4 4 4 4 4 4 4 4 4 4 4 4 4 4
4 0 0 0 0 0 0 0 0 1 0 0 0 0 0 0 0 0 0 4
4 0 0 0 0 0 0 0 0 1 0 7 7 7 7 7 0 0 0 4
4 0 0 0 0 0 0 0 0 1 0 7 5 5 5 7 0 0 0 4
4 0 0 0 0 0 0 0 0 1 0 7 5 5 5 7 0 0 0 4
4 0 0 4 4 4 4 4 4 1 0 7 7 7 7 7 0 0 0 4
4 0 0 4 1 1 1 1 4 1 0 0 0 0 0 0 0 0 0 4
4 0 0 4 1 1 6 1 4 1 0 0 0 0 0 0 0 0 0 4
4 0 0 4 4 4 1 1 4 1 0 0 0 0 0 0 0 0 0 4
4 1 1 1 1 1 1 1 1 1 1 0 0 0 0 0 0 0 0 4
4 0 0 0 0 0 0 0 0 1 1 1 1 1 1 1 1 1 1 4
4 0 0 0 0 0 0 0 0 1 1 1 0 0 0 0 0 0 0 4
4 0 0 0 0 0 0 0 0 1 1 1 0 0 0 0 0 0 0 4
4 1 1 1 1 1 1 1 1 1 1 1 1 1 1 1 1 1 1 4
4 0 0 0 0 0 0 0 0 0 0 0 0 0 0 0 0 0 0 4
4 0 0 0 0 0 0 0 0 0 0 0 0 0 0 0 0 0 0 4
4 0 0 0 0 0 0 0 0 0 0 0 0 0 0 0 0 0 0 4
4 0 0 0 0 0 0 0 0 0 0 0 0 0 0 0 0 0 0 4
4 0 0 0 0 0 0 0 0 0 0 0 0 0 0 0 0 0 0 4
4 4 4 4 4 4 4 4 4 4 4 4 4 4 4 4 4 4 4 4

